00000000000
44444444444
33333533333
33335353333
22252225222
22522222522
15111111151
51111111115