000000000
444444444
333555333
335333533
353333353
000000000
000000000