00000000000
44444444444
35333533353
33535353533
22252425222
22522422522
15111411151
51114441115