44444444444
33333533333
33335353333
22353435322
23532423532
35311411353
53114441135