44444444444
35333533353
33535353533
22353435322
23532423532
35311411353
53114441135