000000000
444444444
333333333
222222222
111111111
000000000
000000000