00000000000
63333633336
56555655565
11611611611
44000000044