00000000000
00000U00000
00000000000
00000000000
00000000000
44000000044